11 11
64 64
2 2 2 2 2 2 2 2 2 2 2
2 1 1 1 1 1 1 1 1 1 2
2 1 2 2 2 2 2 2 2 1 2
2 1 2 1 1 1 1 1 2 1 2
2 1 2 1 2 2 2 1 2 1 2
2 1 1 1 2 0 1 1 2 1 2
2 1 2 1 2 2 2 1 2 1 2
2 1 2 1 1 1 1 1 2 1 2
2 1 2 2 2 2 2 2 2 1 2
2 1 1 1 1 1 1 1 1 1 2
2 2 2 2 2 2 2 2 2 2 2